
NO ./textures/bluestone.xpm
SO ./textures/eagle.xpm
WE ./textures/greystone.xpm
EA ./textures/purplestone.xpm

F 0,33,33
C 0,0,255

11111
10101
10001
10001
10001
10001
10001
10001
10001
10001
10001
10001
10001
10001
10001
10001
10001
10001
10001
10001
10001
10001
10001
10001
10001
10001
10001
10001
10001
10001
10001
10001
10001
10E01
11111


