
NO ./textures/bluestone.xpm
SO ./textures/eagle.xpm
WE ./textures/greystone.xpm
EA ./textures/purplestone.xpm

F 0,33,33
C 255,255,255

11111111111111111111111111
10000000000000000000000001
10000000000000000000000001
10000000000000000000000001
11111111111111111111111111
100000000000S0000000000001
00000000000000000000000000