
NO ./textures/bluestone.xpm
SO ./textures/eagle.xpm
WE ./textures/greystone.xpm
EA ./textures/purplestone.xpm

F 0,33,33
C 0,0,255

111111111111111111111111111111111111111111
102020202020202020202020202020202020202021
120202020202020202020202020202020202020201
102020202020202020202020202020202020202021
1202020202020202N2020202020202020202020201
102020202020202020202020202020202020202021
120202020202020202020202020202020202020201
111111111111111111111111111111111111111111